#### ####
####A####
####C####
#### ####
#### ####
 bDBaACb 
####C####
####A####
##    a##
##p    ##
