#### ####
####A####
####C####
#### ####
#### ####
 bDBaACb 
####C####
####A####
##    a##
##p    ##
-
(4,7), (4,6)
(5,5), (6,5)
(3,5), (2,5)
(4,2), (4,1)
